做做题	zuo'zuo'ti
快递柜	kuai'di'gui
多穿点	duo'chuan'dian
多穿点儿	duo'chuan'dian'er
全栈	quan'zhan
有的用	you'de'yong
区块链	qu'kuai'lian
传参	chuan'can
内测群	nei'ce'qun
自黑	zi'hei
互黑	hu'hei
无限之战	wu'xian'zhi'zhan
灭霸	mie'ba
视奸	shi'jian
自证预言	zi'zheng'yu'yan
烂大街	lan'da'jie
怀疑人生	huai'yi'ren'sheng
心塞	xin'sai
玩儿一会	wan'er'yi'hui
玩一会儿	wan'yi'hui'er
玩儿一会儿	wan'er'yi'hui'er
聊一会	liao'yi'hui
报时喵	bao'shi'miao
落格报时喵	luo'ge'bao'shi'miao
苹方	ping'fang
睡着	shui'zhe
吓死宝宝	xia'si'bao'bao
吓死宝宝了	xia'si'bao'bao'le
泼辣修图	po'la'xiu'tu
隔空投递	ge'kong'tou'di
脱单	tuo'dan
同行	tong'xing
键值对	jian'zhi'dui
十动然拒	shi'dong'ran'ju
细思恐极	xi'si'kong'ji
网飞	wang'fei
奈飞	nai'fei
商业互吹	shang'ye'hu'chui
抖机灵	dou'ji'ling
钢丝球	gang'si'qiu
体制内	ti'zhi'nei
菜鸟裹裹	cai'niao'guo'guo
菜鸟驿站	cai'niao'yi'zhan
左划	zuo'hua
左滑	zuo'hua
数码荔枝	shu'ma'li'zhi
虽迟但到	sui'chi'dan'dao
七牛	qi'niu
又拍云	you'pai'yun
岁寒输入法	sui'han'shu'ru'fa
裸贷	luo'dai
微博	wei'bo
知乎	zhi'hu
杠精	gang'jing
微信	wei'xin
众筹	zhong'chou
现充	xian'chong
锁屏	suo'ping
花呗	hua'bei
推友	tui'you
推友们	tui'you'men
追书神器	zhui'shu'shen'qi
追书	zhui'shu
喜提	xi'ti
端脑	duan'nao
妹纸	mei'zhi
人赢	ren'ying
落格五笔	luo'ge'wu'bi
西剧	xi'ju
英剧	ying'ju
憋说话吻我	bie'shuo'hua'wen'wo
憋说话	bie'shuo'hua
充钱	chong'qian
回血	hui'xie
甩锅	shuai'guo
扎心	zha'xin
肉翻	rou'fan
辅码	fu'ma
大牛双拼	da'niu'shuang'pin
点划	dian'hua
去重	qu'chong
配适	pei'shi
天猫	tian'mao
天猫超市	tian'mao'chao'shi
嗯嗯	en'en
安卓	an'zhuo
内购	nei'gou
男票	nan'piao
尬聊	ga'liao
躺枪	tang'qiang
欧皇	ou'huang
给力	gei'li
中国特供	zhong'guo'te'gong
港水	gang'shui
港行	gang'hang
澳行	ao'hang
美水	mei'shui
美行	mei'hang
欧水	ou'shui
欧行	ou'hang
官换	guan'huan
装逼	zhuang'bi
跑分	pao'fen
直男癌	zhi'nan'ai
直男	zhi'nan
竞品	jing'pin
撒狗粮	sa'gou'liang
美区	mei'qu
日区	ri'qu
傻屌	sha'diao
自提点	zi'ti'dian
店保	dian'bao
闲鱼	xian'yu
面基	mian'ji
软路由	ruan'lu'you
硬路由	ying'lu'you
红轴	hong'zhou
乡非	xiang'fei
隔应	ge'ying
小宝卡	xiao'bao'ka
大宝卡	da'bao'ka
小火箭	xiao'huo'jian
落格工作室	luo'ge'gong'zuo'shi
割韭菜	ge'jiu'cai
穿搭	chuan'da
找虐	zhao'nue
白瞎	bai'xia
拥笃	yong'du
砍功能	kan'gong'neng
匿了	ni'le
跟打器	gen'da'qi
只看过	zhi'kan'guo
箱说齐全	xiang'shuo'qi'quan
磁吸附	ci'xi'fu
穷逼	qiong'bi
虐心	nue'xin
瘦成闪电	shou'cheng'shan'dian
猛毒	meng'du
微操	wei'cao
西虹市首富	xi'hong'shi'shou'fu
冻手	dong'shou
冻脚	dong'jiao
浮层	fu'ceng
鲁蛇	lu'she
线稿	xian'gao
搬砖	ban'zhuan
技术债	ji'shu'zhai
贵巴巴	gui'ba'ba
自嗨	zi'hai
舔狗	tian'gou
央美	yang'mei
重用	chong'yong
极其炫酷	ji'qi'xuan'ku
唇釉	chun'you
握抓	wo'zhua
过渡色	guo'du'se
我画你猜	wo'hua'ni'cai
送码	song'ma
灵魂画手	ling'hun'hua'shou
画手	hua'shou
芝麻粒	zhi'ma'li
过早优化	guo'zao'you'hua
不搭边	bu'da'bian
慢放	man'fang
依赖库	yi'lai'ku
右划	you'hua
瓦坎达	wa'kan'da
刷推	shua'tui
飞猪	fei'zhu
硬广	ying'guang
脱支	tuo'zhi
奔着	ben'zhe
触宝	chu'bao
验梦	yan'meng
还得	hai'dei
砍一半	kan'yi'ban
老熟人	lao'shou'ren
秒传	miao'chuan
骗炮	pian'pao
死肥宅	si'fei'zhai
咋地	za'di
干吃	gan'chi
哦豁	o'huo
放里边	fang'li'bian
友链	you'lian
发推	fa'tui
短租	duan'zu
拧巴	ning'ba
卧蚕	wo'can
叫啥	jiao'sha
小狼毫	xiao'lang'hao
非酋	fei'qiu
特别远	te'bie'yuan
懵逼	meng'bi
钓鱼执法	diao'yu'zhi'fa
大骨架	da'gu'jia
添头	tian'tou
读博	du'bo
外接屏	wai'jie'ping
加价党	jia'jia'dang
降权	jiang'quan
未识别	wei'shi'bie
未保存	wei'bao'cun
未创建	wei'chuang'jian
超大杯	chao'da'bei
胖纸	pang'zhi
竖屏	shu'ping
读屏	du'ping
永居	yong'ju
银蕨	yin'jue
银蕨签证	yin'jue'qian'zheng
大促	da'cu
体感游戏	ti'gan'you'xi
体感	ti'gan
体感套件	ti'gan'tao'jian
隔一会	ge'yi'hui
选择困难症	xuan'ze'kun'nan'zheng
瓩	qian'wa
发任务	fa'ren'wu
丢单	diu'dan
跨屏	kua'ping
雾霾	wu'mai
选啥	xuan'sha
公屏	gong'ping
公频	ping'pin
摔炮	shuai'pao
息屏	xi'ping
技术栈	ji'shu'zhan
打不进来	da'bu'jin'lai
私我	si'wo
蒙错	meng'cuo
改价	gai'jia
大箭头	da'jian'tou
二逼	er'bi
自瞄	zi'miao
自瞄辅助	zi'miao'fu'zhu
端媒体	duan'mei'ti
止饿	zhi'e
移动支付	yi'dong'zhi'fu
穿模	chuan'mo
穿模	chuan'mu
猜解	cai'jie
买爆	mai'bao
单冷	dan'leng
冰丝	bing'si
友商	you'shang
自驱力	zi'qu'li
苦命鸳鸯	ku'ming'yuan'yang
编程方法学	bian'cheng'fang'fa'xue
称著	cheng'zhu
蹿榜	cuan'bang
私教	si'jiao
秒拒	miao'ju
社畜	she'chu
灾备	zai'bei
传纸条	chuan'zhi'tiao
带感	dai'gan
工签	gong'qian
转推	zhuan'tui
夜跑	ye'pao
惯着	guan'zhe
撕逼	si'bi
死斗	si'dou
常亮	chang'liang
不可回收	bu'ke'hui'shou
花臂	hua'bi
花臂男	hua'bi'nan
爆表	bao'biao
锁区	suo'qu
右箭头	you'jian'tou
今日份	jin'ri'fen
今日份的	jin'ri'fen'de
挖孔屏	wa'kong'ping
挖孔	wa'kong
机皇	ji'huang
闹掰	nao'bai
闹掰了	nao'bai'le
土澳	tu'ao
为爱鼓掌	wei'ai'gu'zhang
吻技	wen'ji
吻技好	wen'ji'hao
权游	quan'you
龙妈	long'ma
配饭	pei'fan
泪崩	lei'beng
韵达	yun'da
菜鸡	cai'ji
那啥	na'sha
宅寂	zhai'ji
死侍	si'shi
拉清单	la'qing'dan
绿联	lv'lian
配速	pei'su
好嘞	hao'lei
得嘞	de'lei
真哒	zhen'da
挂马	gua'ma
编程随想	bian'cheng'sui'xiang
匿名术	ni'ming'shu
这两招	zhe'liang'zhao
女孩纸	nv'hai'zhi
侧栏	ce'lan
有吃的	you'chi'de
加戏	jia'xi
槽点	cao'dian
手滑	shou'hua
交规	jiao'gui
日了狗	ri'le'gou
日了狗了	ri'le'gou'le
递签	di'qian
福利姬	fu'li'ji
福利群	fu'li'qun
重启试试	chong'qi'shi'shi
追评	zhui'ping
图床	tu'chuang
想吃的	xiang'chi'de
犯的罪	fan'de'zui
本地号	ben'di'hao
特别吵	te'bie'chao
高玩	gao'wan
进地铁	jin'di'tie
还成	hai'cheng
氪金	ke'jin
吃土	chi'tu
恰饭	qia'fan
一小碗	yi'xiao'wan
最高线	zui'gao'xian
这几代	zhe'ji'dai
发快递	fa'kuai'di
订阅量	ding'yue'liang
裸域	luo'yu
渣男	zha'nan
渣女	zha'nv
光猫	guang'mao
优联	you'lian
掉漆	diao'qi
剁手	duo'shou
日抛	ri'pao
月抛	yue'pao
年抛	nian'pao
甩棍	shuai'gun
奔现	ben'xian
壁咚	bi'dong
口嗨	kou'hai
干别的	gan'bie'de
彩虹屁	cai'hong'pi
站方	zhan'fang
掰不开	bai'bu'kai
怂包	song'bao
小粉红	xiao'fen'hong
插排	cha'pai
削发器	xiao'fa'qi
电子签	dian'zi'qian
长租	chang'zu
抽纸	chou'zhi
拼手气	pin'shou'qi
痛呼	tong'hu
裸连	luo'lian
肉偿	rou'chang
踩奶	cai'nai
磅金	bang'jin
集显	ji'xian
狸花	li'hua
吸猫	xi'mao
胖揍	pang'zou
猫砂	mao'sha
提权	ti'quan
血氧仪	xue'yang'yi
封城	feng'cheng
抱关执籥	bao'guan'zhi'yue
抱关执龠	bao'guan'zhi'yue
暴虎凭河	bao'hu'ping'he
曝鳃之鱼	bao'sai'zhi'yu
币安	bi'an
武冠病毒	wu'guan'bing'du
新冠病毒	xin'guan'bing'du
新冠	xin'guan
外链	wai'lian
免备案	mian'bei'an
抓包	zhua'bao
电批	dian'pi
不授	bu'shou
不瘦	bu'shou
充做	chong'zuo
静电容	jing'dian'rong
快克	kuai'ke
互金	hu'jin
带货	dai'huo
伤敌一千	shang'di'yi'qian
自损八百	zi'sun'ba'bai
抹药	mo'yao
隐适美	yin'shi'mei
版号	ban'hao
任地狱	ren'di'yu
冲塔	chong'ta
死道友不死贫道	si'dao'you'bu'si'pin'dao
盲猜	mang'cai
硅脂	gui'zhi
积热	ji're
二签	er'qian
龙岭迷窟	long'ling'mi'ku
魔改	mo'gai
妙控	miao'kong
妙控键盘	miao'kong'jian'pan
妙控鼠标	miao'kong'shu'biao
谢啦	xie'la
投屏	tou'ping